保良局羅傑承（一九八三）中學 -> 保良局罗傑承（一九八三）中学
保良局馬錦明夫人章馥仙中學 -> 保良局马錦明夫人章馥仙中学
保良局馬錦明中學 -> 保良局马錦明中学
保良局顏寶鈴書院 -> 保良局顏寶鈴书院
保祿六世書院 -> 保祿六世书院
寶安商會王少清中學 -> 寶安商会王少清中学
寶覺中學 -> 寶觉中学
寶血會上智英文書院 -> 寶血会上智英文书院
寶血女子中學 -> 寶血女子中学
萬鈞伯裘書院 -> 萬鈞伯裘书院
博愛醫院八十週年鄧英喜中學 -> 博愛医院八十週年鄧英喜中学
博愛醫院陳楷紀念中學 -> 博愛医院陈楷纪念中学
博愛醫院鄧佩瓊紀念中學 -> 博愛医院鄧佩瓊纪念中学
博愛醫院歷屆總理聯誼會梁省德中學 -> 博愛医院历屆总理联誼会梁省德中学
長沙灣天主教英文中學 -> 长沙灣天主教英文中学
陳樹渠紀念中學 -> 陈樹渠纪念中学
德愛中學 -> 德愛中学
德貞女子中學 -> 德貞女子中学
鄧鏡波學校 -> 鄧鏡波学校
鄧肇堅維多利亞官立中學 -> 鄧肇堅维多利亞官立中学
地利亞修女紀念學校（百老匯） -> 地利亞修女纪念学校（百老匯）
地利亞修女紀念學校（吉利徑） -> 地利亞修女纪念学校（吉利径）
地利亞修女紀念學校（協和二中） -> 地利亞修女纪念学校（协和二中）
地利亞修女紀念學校（協和） -> 地利亞修女纪念学校（协和）
東華三院馮黃鳳亭中學 -> 东华三院馮黄凤亭中学
東華三院郭一葦中學 -> 东华三院郭一葦中学
東華三院鄺錫坤伉儷中學 -> 东华三院鄺錫坤伉儷中学
東華三院李嘉誠中學 -> 东华三院李嘉誠中学
東華三院李潤田紀念中學 -> 东华三院李潤田纪念中学
東華三院盧幹庭紀念中學 -> 东华三院卢幹庭纪念中学
東華三院呂潤財紀念中學 -> 东华三院呂潤财纪念中学
東華三院吳祥川紀念中學 -> 东华三院吳祥川纪念中学
東莞工商總會劉百樂中學 -> 东莞工商总会劉百樂中学
紡織學會美國商會胡漢輝中學 -> 紡织学会美国商会胡汉輝中学
粉嶺禮賢會中學 -> 粉岭礼賢会中学
鳳溪廖萬石堂中學 -> 凤溪廖萬石堂中学
佛教葉紀南紀念中學 -> 佛教葉纪南纪念中学
佛教志蓮中學 -> 佛教志蓮中学
港島民生書院 -> 港島民生书院
港九街坊婦女會孫方中書院 -> 港九街坊婦女会孫方中书院
觀塘功樂官立中學 -> 观塘功樂官立中学
觀塘瑪利諾書院 -> 观塘瑪利諾书院
何明華會督銀禧中學 -> 何明华会督銀禧中学
萬鈞匯知中學 -> 萬鈞匯知中学
基督教女青年會丘佐榮中學 -> 基督教女青年会丘佐榮中学
基督教聖約教會堅樂中學 -> 基督教圣约教会堅樂中学
基督教香港信義會心誠中學 -> 基督教香港信义会心誠中学
迦密愛禮信中學 -> 迦密愛礼信中学
嘉諾撒培德書院 -> 嘉諾撒培德书院
嘉諾撒聖方濟各書院 -> 嘉諾撒圣方济各书院
嘉諾撒聖家書院 -> 嘉諾撒圣家书院
嘉諾撒聖瑪利書院 -> 嘉諾撒圣瑪利书院
嘉諾撒聖心書院 -> 嘉諾撒圣心书院
嘉諾撒書院 -> 嘉諾撒书院
將軍澳香島中學 -> 将军澳香島中学
潔心林炳炎中學 -> 潔心林炳炎中学
浸信會呂明才中學 -> 浸信会呂明才中学
藍田聖保祿中學 -> 藍田圣保祿中学
樂道中學 -> 樂道中学
樂善堂顧超文中學 -> 樂善堂顾超文中学
樂善堂梁銶琚書院 -> 樂善堂梁銶琚书院
樂善堂梁植偉紀念中學 -> 樂善堂梁植偉纪念中学
樂善堂王仲銘中學 -> 樂善堂王仲銘中学
樂善堂楊葛小琳中學 -> 樂善堂楊葛小琳中学
樂善堂余近卿中學 -> 樂善堂余近卿中学
禮賢會彭學高紀念中學 -> 礼賢会彭学高纪念中学
麗澤中學 -> 丽澤中学
廖寶珊紀念書院 -> 廖寶珊纪念书院
林大輝中學 -> 林大輝中学
靈糧堂劉梅軒中學 -> 灵糧堂劉梅軒中学
靈糧堂怡文中學 -> 灵糧堂怡文中学
嶺南鍾榮光博士紀念中學 -> 岭南鍾榮光博士纪念中学
路德會呂明才中學 -> 路德会呂明才中学
路德會呂祥光中學 -> 路德会呂祥光中学
馬錦明慈善基金馬陳端喜紀念中學 -> 马錦明慈善基金马陈端喜纪念中学
馬錦明慈善基金馬可賓紀念中學 -> 马錦明慈善基金马可宾纪念中学
瑪利曼中學 -> 瑪利曼中学
瑪利諾神父教會學校 -> 瑪利諾神父教会学校
瑪利諾修院學校（中學部） -> 瑪利諾修院学校（中学部）
瑪利諾中學 -> 瑪利諾中学
棉紡會中學 -> 棉紡会中学
圓玄學院妙法寺內明陳呂重德紀念中學 -> 圓玄学院妙法寺內明陈呂重德纪念中学
妙法寺劉金龍中學 -> 妙法寺劉金龙中学
閩僑中學 -> 閩侨中学
明愛柴灣馬登基金中學 -> 明愛柴灣马登基金中学
明愛粉嶺陳震夏中學 -> 明愛粉岭陈震夏中学
明愛胡振中書院 -> 明愛胡振中书院
明愛馬鞍山中學 -> 明愛马鞍山中学
明愛聖若瑟中學 -> 明愛圣若瑟中学
明愛屯門馬登基金中學 -> 明愛屯门马登基金中学
明愛元朗陳震夏中學 -> 明愛元朗陈震夏中学
明愛莊月明中學 -> 明愛莊月明中学
南亞路德會沐恩中學 -> 南亞路德会沐恩中学
寧波第二中學 -> 寧波第二中学
寧波公學 -> 寧波公学
青松侯寶垣中學 -> 青松侯寶垣中学
裘錦秋中學（葵涌） -> 裘錦秋中学（葵涌）
裘錦秋中學（屯門） -> 裘錦秋中学（屯门）
裘錦秋中學（元朗） -> 裘錦秋中学（元朗）
荃灣公立何傳耀紀念中學 -> 荃灣公立何传耀纪念中学
荃灣官立中學 -> 荃灣官立中学
荃灣聖芳濟中學 -> 荃灣圣芳济中学
仁愛堂陳黃淑芳紀念中學 -> 仁愛堂陈黄淑芳纪念中学
仁愛堂田家炳中學 -> 仁愛堂田家炳中学
仁濟醫院靚次伯紀念中學 -> 仁济医院靚次伯纪念中学
賽馬會萬鈞毅智書院 -> 赛马会萬鈞毅智书院
嗇色園主辦可藝中學 -> 嗇色园主办可艺中学
嗇色園主辦可譽中學暨可譽小學 -> 嗇色园主办可譽中学暨可譽小学
筲箕灣東官立中學 -> 筲箕灣东官立中学
筲箕灣官立中學 -> 筲箕灣官立中学
神召會康樂中學 -> 神召会康樂中学
聖保祿學校 -> 圣保祿学校
聖保祿中學 -> 圣保祿中学
聖伯多祿中學 -> 圣伯多祿中学
聖公會鄧肇堅中學 -> 圣公会鄧肇堅中学
聖公會呂明才中學 -> 圣公会呂明才中学
聖公會莫壽增會督中學 -> 圣公会莫壽增会督中学
聖公會聖馬利亞堂莫慶堯中學 -> 圣公会圣马利亞堂莫庆堯中学
聖公會聖西門呂明才中學 -> 圣公会圣西门呂明才中学
聖傑靈女子中學 -> 圣傑灵女子中学
聖瑪加利男女英文中小學 -> 圣瑪加利男女英文中小学
聖母無玷聖心書院 -> 圣母無玷圣心书院
聖貞德中學 -> 圣貞德中学
獅子會蔣翠琼中學 -> 獅子会蔣翠琼中学
十八鄉鄉事委員會公益社中學 -> 十八乡乡事委員会公益社中学
石籬天主教中學 -> 石籬天主教中学
世界龍岡學校劉皇發中學 -> 世界龙岡学校劉皇发中学
順德聯誼總會胡兆熾中學 -> 順德联誼总会胡兆熾中学
順德聯誼總會李兆基中學 -> 順德联誼总会李兆基中学
順德聯誼總會梁銶琚中學 -> 順德联誼总会梁銶琚中学
順德聯誼總會譚伯羽中學 -> 順德联誼总会譚伯羽中学
順德聯誼總會翁祐中學 -> 順德联誼总会翁祐中学
順德聯誼總會鄭裕彤中學 -> 順德联誼总会郑裕彤中学
順利天主教中學 -> 順利天主教中学
天水圍官立中學 -> 天水圍官立中学
天水圍香島中學 -> 天水圍香島中学
天水圍循道衞理中學 -> 天水圍循道衞理中学
天主教鳴遠中學 -> 天主教鳴远中学
天主教母佑會蕭明中學 -> 天主教母佑会蕭明中学
威靈頓教育機構張沛松紀念中學 -> 威灵顿教育机構张沛松纪念中学
五旬節聖潔會永光書院 -> 五旬节圣潔会永光书院
西貢崇真天主教學校（中學部） -> 西貢崇真天主教学校（中学部）
香島中學 -> 香島中学
香港道教聯合會鄧顯紀念中學 -> 香港道教联合会鄧显纪念中学
香港道教聯合會圓玄學院第二中學 -> 香港道教联合会圓玄学院第二中学
香港道教聯合會圓玄學院第三中學 -> 香港道教联合会圓玄学院第三中学
香港道教聯合會圓玄學院第一中學 -> 香港道教联合会圓玄学院第一中学
香港鄧鏡波書院 -> 香港鄧鏡波书院
香港管理專業協會李國寶中學 -> 香港管理专业协会李国寶中学
香港浸會大學附屬學校王錦輝中小學 -> 香港浸会大学附屬学校王錦輝中小学
香港九龍塘基督教中華宣道會鄭榮之中學 -> 香港九龙塘基督教中华宣道会郑榮之中学
香港神託會培敦中學 -> 香港神托会培敦中学
香港神託會培基書院 -> 香港神托会培基书院
香港中國婦女會馮堯敬紀念中學 -> 香港中国婦女会馮堯敬纪念中学
香港中國婦女會中學 -> 香港中国婦女会中学
香港仔浸信會呂明才書院 -> 香港仔浸信会呂明才书院
香海正覺蓮社佛教梁植偉中學 -> 香海正觉蓮社佛教梁植偉中学
香海正覺蓮社佛教馬錦燦紀念英文中學 -> 香海正觉蓮社佛教马錦灿纪念英文中学
香海正覺蓮社佛教正覺中學 -> 香海正觉蓮社佛教正觉中学
新界西貢坑口區鄭植之中學 -> 新界西貢坑口区郑植之中学
新生命教育協會呂郭碧鳳中學 -> 新生命教育协会呂郭碧凤中学
新亞中學 -> 新亞中学
伊利沙伯中學舊生會湯國華中學 -> 伊利沙伯中学旧生会湯国华中学
伊斯蘭脫維善紀念中學 -> 伊斯兰脫维善纪念中学
優才（楊殷有娣）書院 -> 优才（楊殷有娣）书院
元朗公立中學校友會鄧兆棠中學 -> 元朗公立中学校友会鄧兆棠中学
張振興伉儷書院 -> 张振兴伉儷书院
中華傳道會李賢堯紀念中學 -> 中华传道会李賢堯纪念中学
中華傳道會劉永生中學 -> 中华传道会劉永生中学
中華基督教會方潤華中學 -> 中华基督教会方潤华中学
中華基督教會馮梁結紀念中學 -> 中华基督教会馮梁结纪念中学
中華基督教會蒙民偉書院 -> 中华基督教会蒙民偉书院
中華基督教會銘基書院 -> 中华基督教会銘基书院
中華基督教會銘賢書院 -> 中华基督教会銘賢书院
中華基督教會譚李麗芬紀念中學 -> 中华基督教会譚李丽芬纪念中学
中華聖潔會靈風中學 -> 中华圣潔会灵风中学
鐘聲慈善社胡陳金枝中學 -> 鐘声慈善社胡陈金枝中学